xxxx#####xxxx
#####...#####
#...#.1.#...#
#.1.......1.#
#...#.p.#...#
#####...#####
xxxx#####xxxx
