#######
#.....#
#.1.1'#
#..p''#
#.1'''#
#'''..#
#######
