xxx####
####..#
#''1..#
#''1.p#
#''1..#
####..#
xxx####

