#########
#'''''''#
#'#...#'#
#'#111#'#
#'''q'''#
#########
