x######
##''''#
#4'11'#
#q...##
#4'11'#
##''''#
x######
