#######
#..1..#
#.4.2.#
#..p..#
#.2.4.#
#..1..#
#######
