xx#########xx
###...1...###
#...#...#...#
#..1..p..1..#
#...#...#...#
#############
