x#######x
x#..1..#x
##1...1##
#...p...#
#.......#
#########
