########
#''''''#
#'''''4#
#''3'''#
#''''q'#
########
