#######
#.....#
#.4#3.#
#..P..#
#######
