xxxx#####
#####'''#
#'''#1.'#
#'q''1.'#
#'''#1.'#
#####'''#
xxxx#####
