######
#''''#
###'q#
###''#
#'41'#
#'2'##
#'''##
######
