xx#####xx
###...###
#'1...1'#
#'1...1'#
#'11111'#
#'''''''#
#'''q'''#
#########
