#########
#..###..#
#..###..#
#..###..#
#.1.1.1.#
x#..p..#x
x#######x
