#########
#'.....'#
#''#1#''#
##''1''##
x#'#4#'#x
x#''q''#x
x#######x

