xxx#####
####'''#
#......#
#.1#4#2#
#......#
####'q'#
xxx#####
