xxx######
####....#
#''...1.#
#41#4p1.#
#''...1.#
####....#
xxx######
