#####
#41'#
#2''#
#q''#
#####
