#####
#6'6#
#1'1#
#q''#
#####
