######
#q1..#
#'1.1#
#''''#
#''''#
######
