#####
#41'#
#.1q#
#'''#
#####
