#########
#''#'''.#
#q'1'22.#
#''#'''.#
#########