#########
####....#
#...4...#
#.1#21p1#
#...4...#
####....#
#########