#######
#.p1..#
#.2.2.#
#.....#
#.#.#.#
#.....#
#######
