#########
#.......#
#...4...#
#.1###1.#
#...p...#
#########
