#########
#.1.1.2.#
#.......#
#...p...#
#########
