#########
#'.....'#
#''#1#''#
##''1''##
##'#4#'##
##''q''##
#########

