#######
##'''##
##1'1##
##...##
#''1''#
#''q''#
#######
