#######
#.....#
#.#'#.#
#.111.#
#.#q#.#
#.....#
#######
