#######
#..#..#
#..#..#
#.111.#
#..p..#
#######
