#######
#.....#
#.4#3.#
#..p..#
#######
