#########
#####'''#
#'''#1.'#
#'q''1.'#
#'''#1.'#
#####'''#
#########
