########
####'''#
#......#
#.1#4#2#
#......#
####'q'#
########
